0,4,0,4,0,0,0
5,5,3,4,0,0,0
6,6,4,4,3,3,3
6,6,4,5,4,4,1
6,6,4,6,4,5,1
6,6,4,6,4,6,1
6,6,4,6,4,6,1
6,6,4,6,4,6,1
6,6,4,6,4,6,1
6,6,4,6,4,6,1
6,6,4,6,4,6,1
6,6,4,6,4,6,1
6,6,4,6,4,6,1
6,6,4,7,4,6,1
7,7,4,4,4,7,1
2,2,2,2,2,2,1
0,0,0,0,0,0,0
0,0,0,0,0,0,0
0,0,0,0,0,0,0
